####################
#@.................#
#.#.##.##..##.##.#.#
#..................#
#............k.CCC.#
#.#.##.##..........#
#.....R............#
#..................#
#.#.##.##..##.##.#.#
#..................#
#..................#
#.#.##.##..#########
#..........#.......#
#.....e....#....R..#
#.#.##.##..#D#.....#
#..........#.#DDDDD#
#..........#_#.....#
#.#.##.##..........#
#..................#
####################
